11111111111111111111111111111111111111
1C0000C00000000000000C0000000000000001
100C0000111000110000000000000000000001
1P0111000000C0000000000CC0000001100001
100000000111000000C0000000000C00000001
1000000001000000C0000000000C000000C001
100C0000111000110000000000000000000001
1C0010C00000000000000C0000000000000001
1C0000C00000000000000C0000000000000001
100C0000111000110000000000000000000001
100111000000C0000000000CC0000001100001
100000000111000000C0000000000C00000001
1000000001000000C0000000000C000000C001
100C0000111000110000000000000000000001
1C00E0C00000000000000C0000000000000001
100C0000111000110000000000000000000001
1C0000C00000000000000C0000000000000001
100C0000111000110000000000000000000001
100111000000C0000000000CC0000000000001
11111111111111111111111111111111111111
