1111111111111111111111111
1E000C00000C000000000C001
1001110001000110010111001
10010C00101C0101010100001
1001000011100110010100001
1P0111010001010101C111001
1000000000000000000000001
1111111111111111111111111
